333333333333333333333
321212222212222121223
312121112112212122213
321212222212222121223
321212222212222121223
312121112112212122213
321212222212222121223
321212222212222121223
312222222222222222223
321212222212222121223
312121112112212122213
321212222212222121223
321212222212222121223
312222222222222222223
321212222212222121223
312121112112212122213
312121112112212122213
311111111222211111113
321212121111122222223
311112222122222111113
333333333333333333333